16,12
18,3,22,32,32,32,32,32,32,32,32,32,32,32,32,32,
6,3,22,32,32,32,32,32,32,32,32,32,32,32,32,32,
23,2,22,32,32,32,32,32,32,32,32,32,32,32,32,32,
23,3,22,32,32,32,32,32,32,32,32,32,32,32,32,32,
23,3,22,32,32,32,32,32,32,32,32,32,32,32,32,32,
23,3,13,24,24,24,24,24,24,24,24,24,24,24,24,24,
23,3,1,3,11,11,11,11,11,11,11,11,11,3,3,3,
28,21,21,21,21,21,21,21,21,21,21,21,21,21,6,3,
32,32,32,32,32,32,32,32,32,32,32,32,32,32,23,2,
32,32,32,32,32,32,32,32,32,32,32,32,32,32,23,3,
32,32,32,32,32,32,32,32,32,32,32,32,32,32,23,19,
32,32,32,32,32,32,32,32,32,32,32,32,32,32,28,21
1
8,6,0,0,0,65,4,2,1,1,1

