16,12,
18,3,22,32,26,24,24,24,24,24,24,24,24,24,24,25,
3,3,22,32,23,3,1,11,11,11,3,17,1,3,3,22,
6,2,22,32,23,3,5,6,3,7,12,5,21,6,3,22,
23,3,22,26,14,17,13,14,3,30,12,22,32,23,12,22,
23,12,22,23,12,3,3,17,3,30,12,13,24,23,12,22,
23,12,13,14,12,7,3,15,21,23,12,17,3,30,12,22,
23,3,3,1,12,30,3,3,13,14,12,7,2,30,12,22,
23,17,5,6,12,22,6,3,3,1,3,30,3,16,12,22,
23,3,22,23,2,22,28,6,3,5,21,23,11,11,11,22,
23,3,13,14,3,13,24,14,3,13,24,24,29,8,2,13,
23,3,3,3,3,17,11,11,11,17,1,3,3,3,3,19,
28,21,21,21,21,21,21,21,21,21,21,21,21,21,21,21
5,
0,0,0,0,1,90,1.5,200,1,1,1,0,0
1,6,0,0,1,90,1.5,200,1,1,1,128,64
4,4,0,0,1,90,1.5,200,1,1,1,0,128
10,4,0,0,1,90,1.5,200,1,1,1,128,128
14,5,0,0,1,90,1.5,200,1,1,1,128,128
