16,12
18,3,22,32,32,32,32,32,32,32,32,32,32,32,32,32,
6,3,13,24,24,24,24,24,24,24,24,24,24,24,25,32,
23,2,3,3,3,17,3,11,11,11,11,11,11,3,22,32,
28,21,21,6,17,5,21,21,21,21,21,21,6,3,22,32,
32,32,32,23,3,22,32,32,32,32,32,32,23,2,22,32,
32,32,32,23,2,22,32,32,32,32,32,32,23,3,22,32,
32,32,32,23,3,13,24,24,24,24,24,25,23,12,22,32,
32,32,32,23,11,11,11,11,11,11,11,22,23,12,22,32,
32,32,32,28,21,21,21,21,21,6,3,22,23,12,22,32,
32,32,32,32,32,32,32,32,32,23,3,13,14,12,13,24,
32,32,32,32,32,32,32,32,32,23,3,3,1,3,3,19,
32,32,32,32,32,32,32,32,32,28,21,21,21,21,21,21
4
0,0,0,0,0,90,1.5,200,1,1,1,0,0
10,2,0,0,0,90,1.5,200,1,1,1,64,64
7,7,0,0,0,90,1.5,200,1,1,1,64,64
13,8,0,0,1,90,1.5,200,1,1,1,64,0

