16,12
0,0,1,1,1,1,1,1,1,1,1,1,1,1,1,1,
0,0,1,1,1,0,0,0,0,0,0,0,0,0,0,1,
1,0,1,1,1,0,1,1,0,1,0,1,1,1,0,1,
1,0,1,1,1,0,1,1,0,1,0,1,1,1,0,1,
1,0,1,1,0,0,0,0,0,1,0,1,1,1,0,1,
1,0,1,1,0,1,0,1,1,1,0,0,0,1,0,1,
1,0,0,0,0,1,0,0,1,1,0,1,0,1,0,1,
1,0,1,1,0,1,1,0,0,0,0,1,0,1,0,1,
1,0,1,1,0,1,1,1,0,1,1,1,0,0,0,1,
1,0,1,1,0,1,1,1,0,1,1,1,1,1,0,1,
1,0,0,0,0,0,0,0,0,0,0,0,0,0,0,0,
1,1,1,1,1,1,1,1,1,1,1,1,1,1,1,1
3,
0,0,0,0,1,0,30,4,4
2,2,0.5,0,1,0,30,4,4
3,4,0.5,0,1,0,30,6,4

