16,12
5,0,1,1,1,1,1,1,1,1,1,1,1,1,1,1,
0,0,1,1,1,0,0,0,0,0,0,0,0,0,0,1,
1,0,1,1,1,0,1,1,0,1,0,1,1,1,0,1,
1,0,1,1,1,0,1,1,0,1,0,1,1,1,0,1,
1,0,1,1,0,0,0,0,0,1,0,1,1,1,0,1,
1,0,1,1,0,1,0,1,1,1,0,0,0,1,0,1,
1,0,8,0,0,1,0,0,1,1,0,1,0,1,0,1,
1,0,1,1,0,1,1,0,0,0,0,1,0,1,0,1,
1,0,1,1,0,1,1,1,0,1,1,1,0,0,0,1,
1,0,1,1,0,1,1,1,0,1,1,1,1,1,0,1,
1,0,0,0,0,0,0,0,0,0,0,0,0,0,0,6,
1,1,1,1,1,1,1,1,1,1,1,1,1,1,1,1
3,
0,0,0,0,0,30,4,2,1,0,0
1,6,0,0,0,30,4,2,0,1,0
4,4,0,0,1,30,4,2,0,0,1

