16,12
5,0,1,1,1,1,1,1,1,1,1,1,1,1,1,1,
0,0,1,1,1,0,0,0,0,0,0,0,0,0,0,1,
1,0,1,1,1,0,1,1,0,1,0,1,1,1,0,1,
1,7,1,1,1,0,1,1,0,1,0,1,1,1,0,1,
1,8,1,1,0,0,0,0,0,1,0,1,1,1,0,1,
1,0,1,1,0,1,0,1,1,1,0,0,0,1,0,1,
1,0,0,0,0,1,0,0,1,1,0,1,0,1,0,1,
1,0,1,1,0,1,1,0,0,0,0,1,0,1,0,1,
1,0,1,1,0,1,1,1,0,1,1,1,0,0,0,1,
1,0,1,1,0,1,1,1,0,1,1,1,1,1,0,1,
1,0,0,0,0,0,0,0,0,0,0,0,0,0,0,6,
1,1,1,1,1,1,1,1,1,1,1,1,1,1,1,1
3,
0,0,0,0,10,30,4,2
0,6,0,0,-60,30,4,2
3,4,0,0,30,30,4,2

