16,12
5,0,1,1,1,1,1,1,1,1,1,1,1,1,1,1,
0,0,1,1,1,0,0,0,0,0,0,0,0,0,0,1,
1,0,1,1,1,0,1,1,0,1,0,1,1,1,0,1,
1,0,1,1,1,0,1,1,0,1,0,1,1,1,0,1,
1,0,1,1,0,0,0,0,0,1,0,1,1,1,0,1,
1,0,1,1,0,1,0,1,1,1,0,0,0,1,0,1,
1,9,8,0,0,1,0,0,1,1,0,1,0,1,0,1,
1,0,1,1,0,1,1,0,0,0,0,1,0,1,0,1,
1,0,1,1,0,1,1,1,0,1,1,1,0,0,0,1,
1,0,1,1,0,1,1,1,0,1,1,1,1,1,0,1,
1,0,0,0,0,0,0,0,0,0,0,0,0,0,0,6,
1,1,1,1,1,1,1,1,1,1,1,1,1,1,1,1
5,
0,0,0,0,0,65,4,2,1,1,1
1,6,0,0,0,65,4,2,1,1,1
4,4,0,0,1,65,4,2,1,1,1
15,10,0,0,1,65,4,2,1,1,1
7,10,0,0,0,65,4,2,1,1,1

